36
14
22 0 0 0 0 0 0 0 0 0 0 0 0 0 0 0 0 0 0 0 0 0 0 0 0 0 0 0 0 0 0 0 0 0 1 22 
22 0 0 0 0 0 0 0 0 0 0 0 0 0 0 0 0 0 0 0 0 0 0 0 0 0 0 0 0 0 0 0 0 0 1 22 
22 0 0 0 0 0 0 0 0 0 0 0 0 0 0 0 0 0 0 0 0 0 0 0 0 0 0 0 0 0 0 0 0 0 1 22 
22 0 0 0 0 0 0 0 0 0 0 0 0 0 0 0 0 0 0 0 0 0 0 0 0 0 0 0 0 0 0 0 0 0 1 22 
22 0 0 0 0 0 0 0 0 0 0 0 0 0 0 0 0 0 0 0 0 0 0 0 0 0 0 0 0 0 0 0 0 0 1 22 
22 0 0 0 0 0 0 0 0 0 0 0 0 0 0 0 0 0 0 0 0 16 0 21 0 0 21 0 0 0 0 0 0 0 1 22 
22 0 0 0 0 0 0 0 0 0 0 0 0 0 0 0 0 0 0 0 0 30 21 22 21 21 22 31 0 0 0 0 0 0 1 22 
22 0 0 0 0 0 0 0 0 0 0 0 0 0 0 0 0 0 0 0 30 22 22 22 0 0 0 22 31 0 0 0 0 0 1 22 
22 0 0 0 0 0 0 0 0 0 0 0 0 0 0 0 0 0 0 30 22 22 22 22 22 0 22 22 0 31 0 0 0 0 1 22 
22 0 0 0 0 0 0 0 0 0 0 0 0 0 0 10 0 11 30 22 22 22 22 22 22 22 22 0 0 22 21 21 21 21 1 22 
22 0 0 0 0 0 0 11 14 0 0 0 0 9 0 21 0 21 0 22 22 22 22 22 22 22 22 22 0 22 22 22 22 0 1 22 
22 0 0 0 0 13 0 30 31 0 0 0 0 30 21 22 21 22 22 22 22 22 22 22 22 22 22 22 22 0 0 0 22 22 1 22 
22 0 0 9 0 10 0 26 27 0 0 0 0 26 0 0 22 22 22 22 22 22 22 22 22 22 22 22 22 22 22 22 22 22 1 22 
22 21 21 21 21 21 21 22 27 0 0 0 0 26 0 0 22 22 22 22 22 22 22 22 22 22 22 22 22 22 22 22 22 22 1 22 
